20
30
##############################
#                            #
#    #                       #
#    #                       #
#    ###                     #
#                            #
#       ____                 #
#       ____                 #
#       ____                 #
#       ____                 #
#       ____                 #
#                            #
#                            #
#                            #
#                            #
#                            #
#                            #
#                            #
#                            #
##############################