20
15
###############
#             #
#  ####       #
#  #  #    @  #
#    #        #
#   #         #
# #   #       #
#   #         #
#    #        #  
#  #  #       #
#  ####       #
#             #
#         @   #
#             #
#             #
#   000       #
#             #
#             #
#             #
###############