26
40
########################################
#e_# _ _ _ _ _ _ _ _@@    _      _     #
# _#_ ###############################@@#
#@@# _#_  _  _  _  _  _  _  _  _  _ #  #
#  #_ # _#########################  #  #
#  # _#T _ TT _ _TT _ _TT _ _TTTT#  #  #
#  #_ #TTT_  _TT _ _TT _ _TT _  T#  #  #
#  # _#######################T __#_____#
#  #_ #_____________________##T _#####@#
#  # _# ###     #    M        ##       #
#  #_ #_#_______________________##     #
#  # _# ##  ### # ### ##### ###  ##### #
#@@#_ #_#___#_#_#_#_#_#_#_#_#_#__#     #
#@@# _# ### # # # ### # # # ## # # #####
#__#_ #_____________#____________#     #
#__# _#    W      ###     W      ##### #
#__#_ @__________________________###   #
#__# _#######@@@##########@@@#@@@##   ##
#__#_ #          T  3  T  E  #       ###
#__# _##@###############################
#__#_ #  #            #      #  @@     #
#__# _#  # ########## # #### # TT##@@@@#
#__#_ #  #      #     # #    #    @@___#
#     #  ###### # ##### # ####T  ##@_S_#
#     #         #       #       ###@___#
########################################