20
15
###############
#        _____#
#  ####  _____#
#  #  #  _____#
#    #   _____#
#   #    _____#
# #   #       #
#   #         #
#    #        #  
#  #  #       #
#  ####       #
#             #
#        W    #
#             #
#             #
#   000       #
#             #
#  @@@   S    #
#             #
###############