20
15
###############
#e       _____#
#  ####  _____#
#  #  #  _____#
#    #   _____#
#   #    _____#
# #   #       #
#   #         #
#    #        #  
#  #  #       #
#  ####       #
#             #
#        W    #
#             #
#             #
#   TTT       #
#             #
#  @@@   S    #
#             #
###############