10
10
##########
#        #
# ###### #
# @    @ #
# @    @ #        
# @    @ #
# @    @ #
# ###### #
#        #
##########