10
10
##########
#        #
# ###### #
# @    @ #
# @    @ #        
# @    @ #
# @S   @ #
# ###### #
#      W #
##########