20
48
################################################
#e  @   @   @   @   @   @@   @@   @@@   @@@    #
#  ###########################################@#
#@@#______@                            #TT   #_#                 #
# T#__#_T_#                            @  _#_#_#
#  #__#___######@@@@##########@@@@######_TT#_#_#
#T #__#T_T#                            #___# #_#
#  #__#___#  ###     #                 #TT #_#_#
# T#__#_T_@  #   W             W       @   #_#_#
#  #__#___@  ##  ### # ### ##### ###   @__T#_#_#
#T #__#T_T@  #   # # # # # # # # # #   @___# #_#
#  #__#___@  ### # # # ### # # # ## #  @ TT#_#_#
# T#__#_T_@              #             @   #_#_#
#  #__#___#  @@  W     ##      W   @@  #__T#_#_#
#T #__#T_T#                            #___# #_#
#  #__#T_T###@@########@@##########@@### T #_#_#
# T#__#T_T#__   #__   #__   #__   #   _@   #___#
#  #__#T_T#  #__#  #__#  #__#  #__#  #_#########
#T  __#T__   #   __#   __#   __#   __#_@@@@@  S#
################################################