10
10
##########
# T      #
#        #
# E3WM   #
#  @@@   #        
#     T  #
#   O    #
#        #
#   X    #
##########