13
10
##########
#        #
#  ####  #
#  #  #  #
#    #   #
#   #    #
# #   #  #
#   #    #
#    #   #
#  #  #  #
#  ####  #
#        #
##########